length 12 height 12
xxxxxxxxxxxx
x..........x
x..........x
x..........x
x..........x
x.x........x
x..........x
x..........x
x..........x
x.....x....x
x..........x
xxxxxxxxxxxx
